2,2,2,2,2,2,2,2,2,2,2,2,2,2,2,2,2,2,2,2,2,2,2,2,2,2,2,2,2,2,2,2,2,2,2,2,2,2,2,2,2,2,2,2,2,2,2,2,2,2,2,2,2,2,2,2,2,2,2,2,2,2,2,2
2,1,1,2,1,1,1,1,1,2,1,1,1,1,1,1,2,1,2,1,1,1,1,1,1,1,1,2,1,1,1,2,1,1,1,1,1,1,1,1,1,1,1,1,1,1,1,1,1,2,2,2,2,2,2,2,2,1,2,2,2,2,2,2
2,2,1,1,1,1,2,2,1,2,2,1,2,1,2,1,2,1,1,1,2,1,2,2,2,2,1,2,1,2,1,2,1,1,1,1,1,1,1,2,2,2,2,1,2,2,2,1,1,2,2,1,1,1,1,1,1,1,1,1,1,1,1,2
2,2,1,2,2,1,1,2,1,2,1,1,2,2,1,1,2,2,2,1,2,1,1,1,1,1,2,2,1,2,1,1,1,1,1,2,1,2,1,1,1,1,2,1,1,1,2,1,1,1,2,1,2,2,1,2,2,1,2,2,1,2,1,2
2,2,1,2,1,1,1,2,1,2,2,1,2,2,1,2,2,1,2,1,2,2,2,2,1,2,1,2,1,1,2,2,1,2,1,2,1,1,1,2,1,2,2,2,2,1,2,1,2,1,1,1,2,1,1,1,1,1,1,2,1,2,1,2
2,1,2,2,2,2,1,2,1,2,1,1,2,2,1,1,2,1,2,1,1,1,1,2,1,1,1,2,1,2,1,2,2,1,1,2,2,2,1,2,1,1,1,1,1,2,2,1,2,1,2,2,2,2,1,2,2,1,2,2,1,1,1,2
2,1,1,2,1,1,1,2,1,2,2,1,2,2,2,1,2,1,2,2,1,2,1,2,2,2,1,1,1,2,1,2,2,1,2,2,1,2,1,2,2,2,2,1,2,1,2,1,1,2,1,2,1,1,1,1,1,2,2,2,1,2,2,2
2,2,1,1,1,2,2,2,1,1,1,1,2,2,2,1,1,1,1,2,1,2,1,1,1,1,2,2,1,2,1,2,2,1,1,2,1,2,1,1,1,1,2,1,1,1,2,1,2,1,1,2,2,2,1,2,1,1,2,2,1,1,1,2
2,1,2,2,1,2,1,1,2,2,2,2,1,1,2,2,1,2,1,2,2,2,1,2,2,1,2,2,1,1,1,2,2,2,1,2,1,2,2,1,2,1,2,2,2,1,1,1,2,1,1,1,1,1,1,2,1,2,2,2,1,2,1,2
2,D,1,1,1,1,1,1,1,1,2,1,1,1,1,1,1,2,1,1,1,1,1,2,1,1,1,1,1,2,1,2,2,2,1,1,1,1,2,1,2,1,1,1,1,2,2,1,2,1,1,2,2,1,2,2,1,2,2,2,1,2,1,2
2,2,2,2,2,1,2,2,2,2,2,1,2,2,1,2,2,1,2,2,2,2,1,2,2,2,2,2,2,2,2,1,1,2,2,1,2,1,2,2,2,1,2,2,1,2,2,1,1,1,2,2,1,1,1,1,1,2,2,2,1,2,1,2
2,2,1,2,2,1,2,2,1,2,2,1,2,2,1,2,2,1,1,1,1,2,1,1,1,1,2,1,1,1,2,1,1,1,1,1,2,1,1,1,1,1,2,1,1,1,1,1,2,1,2,2,2,2,2,2,2,2,1,2,1,2,1,2
2,2,1,1,1,2,1,1,1,1,1,2,1,1,1,2,2,2,2,2,1,2,2,1,2,2,2,1,2,1,2,2,1,2,1,1,1,1,1,2,1,1,1,1,1,2,1,1,1,1,2,1,1,1,1,1,1,1,1,1,1,2,1,2
2,2,2,2,2,2,2,2,1,2,1,2,1,2,1,1,1,1,1,1,1,1,1,1,1,1,1,1,2,1,2,2,1,2,2,2,2,1,1,2,2,2,2,1,1,2,2,2,2,1,2,2,2,2,2,2,2,2,2,2,2,2,1,2
2,2,1,1,1,1,1,1,1,2,1,2,1,1,1,2,2,2,2,2,1,2,2,2,1,2,1,2,1,1,1,2,1,1,1,1,2,1,1,1,1,1,2,1,1,1,1,1,2,1,1,1,1,1,1,1,1,1,2,1,1,1,1,2
2,2,1,1,2,1,2,2,2,2,1,2,2,2,1,1,1,1,1,1,1,2,1,2,1,2,2,1,2,2,1,2,2,1,2,1,2,2,2,1,2,1,2,2,2,1,2,1,2,2,2,1,2,2,1,2,2,1,2,1,2,2,2,2
2,2,1,2,2,1,2,2,1,1,1,1,1,2,1,2,2,1,2,2,2,2,1,1,1,2,1,1,1,1,1,1,2,1,2,1,1,1,2,1,2,1,1,1,2,1,2,1,1,1,1,1,2,1,1,1,1,1,2,1,1,1,1,2
2,1,1,1,1,1,1,1,1,1,1,1,1,2,2,1,2,1,1,1,1,1,1,2,2,2,2,1,2,2,1,2,1,2,1,2,1,1,1,2,1,2,2,2,2,1,2,1,2,1,2,2,2,2,1,2,2,1,2,2,2,2,1,2
2,2,2,2,2,2,2,2,2,1,1,1,1,1,2,1,2,2,1,2,2,1,2,1,2,1,1,1,1,1,2,2,2,1,1,2,2,2,1,2,1,1,1,1,1,2,2,1,2,1,1,2,1,1,1,1,1,2,2,1,1,1,1,2
2,2,1,1,1,1,1,1,1,1,1,1,2,1,1,1,1,1,1,2,1,1,1,1,2,2,2,1,2,1,1,2,2,1,2,2,1,2,1,2,2,2,2,1,2,1,2,1,1,2,1,2,2,2,1,2,1,1,2,1,2,2,2,2
2,1,1,2,2,2,2,2,2,2,2,2,2,2,1,2,2,1,2,1,1,2,2,1,1,1,1,1,2,1,2,2,2,1,1,2,1,2,1,1,1,1,2,1,1,1,2,1,2,1,1,1,1,1,1,2,1,2,2,1,1,1,1,2
2,2,2,2,1,1,1,1,1,1,2,1,2,2,1,1,1,1,1,1,2,1,1,1,2,2,1,2,2,1,2,2,2,2,1,2,1,2,2,1,2,1,2,2,2,1,1,1,2,1,1,2,2,1,2,2,1,2,2,2,2,2,1,2
2,2,1,1,1,2,2,2,2,1,1,1,1,1,1,2,2,1,2,1,2,1,2,2,2,1,1,1,1,1,2,2,2,2,1,1,1,1,2,1,2,1,1,1,1,2,2,1,2,1,2,2,1,1,1,1,1,2,2,1,1,1,1,2
2,2,1,2,2,2,2,2,2,2,2,2,2,2,2,2,2,2,2,2,2,2,2,2,2,2,2,2,2,2,2,1,1,2,2,1,2,1,2,2,2,1,2,2,1,2,2,1,1,1,2,2,2,2,2,2,2,2,2,1,2,2,2,2
2,2,1,1,1,1,1,1,1,1,1,1,1,1,1,1,1,1,1,1,1,1,1,1,1,1,1,1,1,1,1,1,1,1,1,1,2,1,1,1,1,1,2,1,1,1,1,1,2,1,1,1,1,1,1,1,1,1,2,1,1,1,1,2
2,2,2,2,2,2,2,2,2,2,2,2,2,2,2,2,2,2,2,2,2,2,2,2,2,1,1,2,2,2,2,1,2,2,1,1,2,2,2,2,1,2,1,1,2,2,2,2,1,2,2,1,1,2,2,2,2,1,2,2,2,2,1,2
2,2,1,2,2,2,2,1,2,2,2,1,2,2,1,2,2,1,1,1,2,1,2,1,2,1,1,1,1,1,2,1,1,2,1,1,1,1,1,2,1,2,1,1,1,1,1,2,1,1,2,1,1,1,1,1,2,1,2,1,1,1,1,2
2,2,1,1,1,1,2,1,1,1,1,1,2,1,1,1,1,1,2,1,2,1,2,1,2,2,2,1,2,1,2,2,1,2,2,2,1,2,1,2,2,2,2,2,1,2,1,2,2,1,2,2,2,1,2,1,2,2,2,1,2,2,2,2
2,1,2,2,2,2,1,2,2,2,2,1,2,2,2,2,2,2,2,2,1,1,2,1,1,1,2,1,2,1,1,1,1,1,1,2,1,2,1,1,1,1,1,2,1,2,1,1,1,1,1,1,2,1,2,1,1,1,2,1,1,1,1,2
2,1,1,1,1,2,1,1,1,1,2,1,1,1,1,2,1,1,1,2,1,1,2,2,1,1,1,2,1,2,2,2,2,1,1,1,2,1,2,2,2,1,1,1,2,1,2,2,2,2,1,1,1,2,1,2,2,2,2,2,2,2,1,2
2,2,2,2,1,2,2,2,2,1,2,2,1,2,2,2,1,2,1,2,2,1,2,2,2,2,1,2,1,1,1,1,2,2,2,1,2,1,1,1,1,2,2,1,2,1,1,1,1,2,2,2,1,2,1,1,1,1,2,1,1,1,1,2
2,1,1,1,1,1,1,1,1,1,1,1,1,1,1,1,1,2,1,2,2,1,2,2,1,2,1,2,2,2,2,1,2,1,2,1,2,2,2,2,1,1,2,1,2,2,2,2,1,2,1,2,1,2,2,2,2,1,2,1,2,2,2,2
2,2,2,2,1,2,2,2,2,1,2,2,2,1,2,1,2,1,1,1,2,1,2,2,1,2,1,1,1,1,2,1,2,1,2,1,1,1,1,2,1,1,2,1,1,1,1,2,1,2,1,2,1,1,1,1,2,1,2,1,1,1,1,2
2,1,1,1,1,2,1,1,1,1,2,1,2,1,2,2,1,2,2,1,2,1,2,2,1,2,2,1,2,1,2,2,2,1,2,2,1,2,1,2,2,1,2,2,1,2,1,2,2,2,1,2,2,1,2,1,2,2,2,2,2,2,1,2
2,1,2,2,2,2,1,2,2,2,2,1,1,1,2,1,1,1,1,1,1,1,2,1,1,1,2,1,2,1,1,1,1,1,1,2,1,2,1,1,1,1,1,2,1,2,1,1,1,1,1,1,2,1,2,1,1,1,2,1,1,1,1,2
2,1,1,1,1,1,1,1,1,1,1,1,2,2,2,2,1,2,2,1,2,1,2,1,2,1,2,2,2,1,2,2,1,2,1,2,2,2,1,2,2,2,1,2,2,2,1,2,2,1,2,1,2,2,2,1,2,2,2,1,2,2,2,2
2,2,1,2,2,1,2,1,2,2,1,2,1,2,1,1,1,1,1,2,2,1,2,1,2,1,1,1,1,1,2,1,1,2,1,1,1,1,1,2,1,2,1,1,1,1,1,2,1,1,2,1,1,1,1,1,2,1,2,1,1,1,1,2
2,1,1,2,1,1,1,1,2,1,1,1,1,2,2,2,1,2,1,1,2,1,2,2,2,2,2,2,2,2,2,2,2,2,2,2,2,2,2,2,2,2,2,2,2,2,2,2,2,2,2,2,2,2,2,2,2,2,2,2,2,2,1,2
2,2,2,2,2,2,2,2,2,2,2,2,1,2,2,2,2,2,2,1,2,1,1,1,2,1,2,2,2,2,1,1,2,1,2,1,1,1,1,2,1,1,2,1,2,1,1,1,2,1,1,1,2,1,2,1,1,1,2,1,1,1,1,2
2,1,1,1,1,1,1,1,1,1,1,1,1,1,2,1,2,1,2,1,2,1,2,2,2,2,2,1,1,2,1,1,1,2,1,2,2,2,2,1,2,1,1,2,1,2,2,2,2,1,2,1,1,2,1,2,2,2,2,1,2,2,2,2
2,2,2,2,1,2,2,2,2,1,2,2,2,1,2,1,1,1,2,1,1,1,1,1,1,1,2,1,1,1,1,2,1,2,1,1,1,1,2,1,2,2,1,2,1,1,1,1,2,1,1,2,1,2,1,1,1,1,2,1,1,1,1,2
2,1,1,1,1,2,1,1,1,1,2,1,2,1,2,1,2,1,1,2,2,2,1,2,1,1,1,1,2,1,1,2,1,2,2,2,2,1,2,1,2,2,1,2,2,2,2,1,2,1,2,2,1,2,2,2,2,1,2,2,2,2,1,2
2,1,2,2,2,2,1,2,2,2,2,1,1,1,2,1,2,2,1,2,1,1,2,1,1,2,2,2,2,1,2,2,1,1,1,1,2,1,1,1,1,2,1,1,1,1,2,1,1,1,1,2,1,1,1,1,2,1,2,1,1,1,1,2
2,1,1,1,1,1,1,1,1,1,1,1,1,1,1,1,2,1,2,1,2,2,1,2,1,1,1,1,2,1,1,2,2,1,2,1,2,2,2,1,2,2,2,1,2,1,2,2,2,1,2,2,2,1,2,1,2,2,2,1,2,2,2,2
2,1,2,2,2,1,2,2,2,2,1,2,2,2,1,1,2,1,2,1,1,1,1,2,1,2,1,1,2,1,2,1,2,1,2,1,1,1,1,1,2,1,2,1,2,1,1,1,1,1,1,1,2,1,2,1,1,1,2,1,1,1,1,2
2,2,1,1,1,1,2,1,1,1,1,2,1,2,1,1,2,1,2,2,2,2,2,2,1,2,1,1,2,1,2,1,2,2,2,1,2,2,1,1,1,1,2,2,2,1,2,2,2,1,2,1,2,2,2,1,2,1,1,2,2,1,2,2
2,2,1,2,2,2,2,1,2,2,2,2,1,1,1,1,2,1,1,1,1,1,1,1,1,1,1,1,2,1,1,1,1,1,1,1,1,2,2,2,2,1,1,1,1,1,1,2,2,1,2,1,2,1,2,2,2,1,1,1,1,1,2,2
2,2,1,2,2,2,2,2,2,2,2,2,2,2,2,2,2,2,2,2,2,2,2,2,2,2,2,2,2,2,2,2,2,2,2,2,2,2,2,2,2,2,2,2,2,2,2,2,2,2,2,2,2,2,2,2,2,2,2,2,2,2,2,2
2,2,1,1,1,1,1,1,1,1,1,1,1,1,1,1,1,1,1,1,1,1,1,1,1,1,1,1,1,1,1,1,1,1,1,1,1,1,1,1,1,1,1,1,1,1,1,1,1,1,1,1,1,1,1,1,1,1,1,1,1,1,A,2
2,2,2,2,2,2,2,2,2,2,2,2,2,2,2,2,2,2,2,2,2,2,2,2,2,2,2,2,2,2,2,2,2,2,2,2,2,2,2,2,2,2,2,2,2,2,2,2,2,2,2,2,2,2,2,2,2,2,2,2,2,2,2,2
